NO ./Wall1.xpm
SO ./Wall2.xpm
EA ./Wall1.xpm
WE ./Wall2.xpm

C 200, 100, 1
F 200, 254, 12

              111111111
111111111   111000000011
100000001111111000000001
10000W000000000001111111
111111111101001111
  1      100001
  1      111111 
  1

