NO ./pouet
SO ./pouet2
EA ./pouet3
WE ./pouet4
F (200, 300, 1)
C (200, 300, 1)

   111111
100W00001111
1000000001
111111111
  1
  1

