NO ./pouet
SO ./pouet2
EA ./pouet3
WE ./pouet4
F (200, 300, 1)
C (200, 300, 1)


              11111111
 1111111    11100000001
100000001111111000000001
100000000W000001111111
11111111110000111
  1      100001
  1      111111
  1
