    NO ./pouet.xpm
SO ./pouet2.xpm
EA ./pouet3.xpm
WE ./pouet4.xpm

C 200, 100, 1
F 200, 254, 12

              111111111
111111111   111000000011
100000001111111000000001
10000W000000000001111111
111111111100001111
  1      100001     
  1      111111 
  1

