NO ./pouet.xpm
SO ./pouet2.xpm
EA ./pouet3.xpm
WE ./pouet4.xpm

C 200, 100, 1
F 200, 254, 12

1111111111111111111
1000000000100000001
1000000000000000001
1000000W00001000001
1001000000010000001
1000000000100000001
1000010000001000001
1000000010000000001
1000000000000000001
1111111111111111111
