
NO ./Wall1.xpm
SO ./Wall2.xpm
EA ./Wall1.xpm
WE ./Wall2.xpm

C 200, 100, 1
F 200, 254, 12

111111111111111111111
100000000000000000001
100000000000000000001
100001000000000000001
100000100000000000001
100000010000000000001
100000001000000000001
1000000000E0000000001
100000000000000000001
100000000000000000001
100000000001110000001
100000000000000000001
100000000000010000001
100000000000000000001
111111111111111111111
