NO ./pouet.xpm
SO ./pouet.xpm
EA ./pouet.xpm
WE ./pouet.xpm

C 200, 100, 1
F 200, 254, 12

111111111111111111111
100000000000000000001
100000000000000000001
100000000000000000001
100000000000000000001
100000000000000000001
100000000000000000001
1000000000E0000000001
100000000000000000001
100000000000000000001
100000000000000000001
100000000000000000001
100000000000000000001
100000000000000000001
111111111111111111111
