NO ./pouet.xpm
SO ./pouet2.xpm
EA ./pouet3.xpm
WE ./pouet4.xpm

C 200, 100, 1
F 200, 254, 12

11111111
10000001
10000001
100W0001
10000001
10000001
11111111
