NO ./wood.xpm
SO ./concrete1.xpm
WE ./rock.xpm
EA ./brick1.xpm

C 200, 100, 1
F 200, 254, 12

              1111111111
111111111   111000000011
100000001111111000000001
10000N000000000011111111
111111111101001111
  1      100001
  1      111111 
  1
  1
  1
  111111111111111
  111111111000001
  111100000000001
  111100000000001
  111000000000001
  111111111111111
  111111111000001
  111100000000001
  111100000000001
  111000000000001
  111111111111111
  111111111000001
  111100000000001
  111100000000001
  111000000000001
  111111111111111
  111111111000001
  111100000000001
  111100000000001
  111000000000001
  111111111111111
  111111111000001
  111100000000001
  111100000000001
  111000000000001
  111111111111111
  111111111000001
  111100000000001
  111100000000001
  111000000000001
  111111111111111
  111111111000001
  111100000000001
  111100000000001
  111000000000001
  111111111111111
  111111111111111
  111111111000001
  111100000000001
  111100000000001
  111000000000001
  111111111111111
  111111111000001
  111100000000001
  111100000000001
  111000000000001
  111111111111111
  111111111111111
  111111111000001
  111100000000001
  111100000000001
  111000000000001
  111111111111111
  111111111000001
  111100000000001
  111100000000001
  111000000000001
  111111111111111
  111111111111111
  111111111000001
  111100000000001
  111100000000001
  111000000000001
  111111111111111
  111111111000001
  111100000000001
  111100000000001
  111000000000001
  111111111111111
  111111111111111
  111111111000001
  111100000000001
  111100000000001
  111000000000001
  111111111111111
  111111111000001
  111100000000001
  111100000000001
  111000000000001
  111111111111111
