NO ./include/maps/xpm/NORTH.xpm
SO ./include/maps/xpm/SOUTH.xpm
EA ./include/maps/xpm/EAST.xpm
WE ./include/maps/xpm/WEST.xpm

C 200, 100, 1
F 200, 255, 12


1111111111
1000000001
100W001111
1000001011
1111111111
